A	AH
A(2)	EY
ALIKE;	AH L AY K
AN	AE N
AN(2)	AH N
AND	AH N D
AND(2)	AE N D
ARCHITECTURE,	AA R K AH T EH K CH ER
AS	AE Z
AS(2)	EH Z
BAD	B AE D
BANKS	B AE NG K S
BEYOND	B IH AA N D
BEYOND(2)	B IY AO N D
BEYOND(3)	B IH AO N D
BOTH	B OW TH
BY	B AY
CHANCE.	CH AE N S
CITY	S IH T IY
DODGY	D AA JH IY
DRAWING	D R AO IH NG
DUNDEE	D AH N D IY
DUNDEE,	D AH N D IY IY
ENJOY,	EH N JH OY
FANTASTIC	F AE N T AE S T IH K
FINDS	F AY N D Z
FIRTH	F ER TH
FORMER	F AO R M ER
FROM	F R AH M
GENERALLY	JH EH N ER AH L IY
GENERALLY(2)	JH EH N R AH L IY
GLAMOROUS	G L AE M ER AH S
GLANCE,	G L AE N S
HARD	HH AA R D
HAS	HH AE Z
HAS(2)	HH AH Z
HISTORY,	HH IH S T AH R IY
HOME-GROWN	HH OW M G R OW N
IGNORED	IH G N AO R D
INCREDIBLE	IH N K R EH D AH B AH L
INDEED	IH N D IY D
IS	IH Z
IT	IH T
ITS	IH T S
IT’S	IH T S
LATTER.	L AE T ER
LESS	L EH S
LOOKING	L UH K IH NG
NORTHERN	N AO R DH ER N
OF	AH V
OFTEN	AO F T AH N
OFTEN(2)	AO F AH N
ON	AA N
ON(2)	AO N
OVERSEAS	OW V ER S IY Z
PASSED-OVER	P AE S T OW V ER
PLACE	P L EY S
PLACES	P L EY S AH Z
PLACES(2)	P L EY S IH Z
PRESS	P R EH S
REPUTATION	R EH P Y AH T EY SH AH N
SECOND	S EH K AH N D
SHIFT,	SH IH F T
SOME	S AH M
TAY	T EY
THAT	DH AE T
THAT(2)	DH AH T
THE	DH AH
THE(2)	DH IY
TO	T UW
TO(2)	T IH
TO(3)	T AH
VISIT	V IH Z IH T
VISIT.	V IH Z AH T
VISITORS	V IH Z IH T ER Z
WELL	W EH L
WORTH	W ER TH
YET,	Y EH T
‘80S	EY T Z IY R OW EH S
